1111111111111
10000000C0001
1000111111011
1P0011E000011
1111111111111
