1111111111111111111111111111111111
1E1000000010000C00000C000000010001
1010010100100000101001000000010101
1010010010101010001001000000000101
100000000C00C00000P0000000000100C1
1111111111111111111111111111111111
