111111111111
111C101C01P1
1110001E0001
100000100001
10000C100001
101111100001
100000C00001
100000000001
111111111111
